R  800 800
NO ./texture/game1.xpm
SO ./texture/game1.xpm
WE ./texture/game2.xpm
EA ./texture/game2.xpm
S ./texture/banana.xpm
S1 ./texture/mush.xpm
S2 ./texture/end.xpm
F 175,202,121
C 153,212,228
1111111111111111111111111111111111111111111111111111111111111
1111111111111111111110E00000000300000000000000000000001111111
1111111111111111111110000000000000000000002000000000001111111
1111111111111111111111111111111111111111111111111110001111111
1111111111111111111111111100000000000000000000000000301111111
1111111111111111111111111100000000000000000000000000001111111
1110040111111111111111111100011111101110111011111111111111111
1110000111111111111111111100000000000000030000000001111111111
1110000111111111111111111100000020000000000000010001111111111
1110000111111111111111111111111111111111111111110021111111111
1110000111111111111111111111111111111111111111110001111111111
1110000111111000000000300000000000011111111111110001111111111
1110200111111000000000000000000000011111111111110001111111111
1110000111111000111111111111110000011111111111110001111111111
1110000111111000111111111111110000011111111111130000000001111
1110000111111000200000000000000000011111111111111111100001111
1110300111111000111111111111110000011111111111111111100001111
1110000000000000111111111111110000011111111111111111100001111
1110000000000000111111111111110000000000000000030000000000111
1111111111111111111111111111110000000002000000000000000000111
1111111111111111111111111111111111111111111111111111111111111
