R 800 800
NO ./texture/game1.xpm
SO ./texture/game1.xpm
WE ./texture/game2.xpm
EA ./texture/game2.xpm
S ./texture/banana.xpm

F 144,144,144
C 131,173,210
111111111111111111111111111111111111
100000000000000000001100000000000001
101100000000000000200000000000000001
100000000000000000001100000000000001
10110000000000000E200000000000000001
100000000000000000001100000000000001
101100000000000000200000000000000001
100000000000000000001100000000000001
101100000000000000200000000000000001
100000000000000000001100000000000001
101100000000000000200000000000000001
100000000000000000001100000000000001
101100000000000000200000000000000001
111111111111111111111111111111111111
